rakimov@invest.gazprom.ru	egusakova@invest.gazprom.ru						
vkuzmenko@invest.gazprom.ru	szemskov@invest.gazprom.ru						
zhkrotchenko@invest.gazprom.ru	arodionov@invest.gazprom.ru						
asagalaeva@invest.gazprom.ru	ktesyul@invest.gazprom.ru						
tlarchenko@invest.gazprom.ru	vvedernikov@invest.gazprom.ru						
ezhukov@invest.gazprom.ru	dklimenko@invest.gazprom.ru						
npestunov@invest.gazprom.ru	vsimonov@invest.gazprom.ru						
aokuznetsov@invest.gazprom.ru	ryun@invest.gazprom.ru						
aperfilev@invest.gazprom.ru	ikapitonov@invest.gazprom.ru						
ikapitonov@invest.gazprom.ru	aperfilev@invest.gazprom.ru						
ikuznetsova@invest.gazprom.ru	achepor@invest.gazprom.ru						
edasis@invest.gazprom.ru	sbakunina@invest.gazprom.ru						
yuvyborov@invest.gazprom.ru	iustinov@invest.gazprom.ru						
ntenkov@invest.gazprom.ru	achugunov@invest.gazprom.ru						
skravtsov@invest.gazprom.ru							
iguschin@invest.gazprom.ru	dni@invest.gazprom.ru						
epavlov@invest.gazprom.ru	nbrichikov@invest.gazprom.ru						
dsukhomlinov@invest.gazprom.ru	dlevin@invest.gazprom.ru						
azatsepin@invest.gazprom.ru	kartemev@invest.gazprom.ru						
atekeev@invest.gazprom.ru	vkarnauhova@invest.gazprom.ru						
apastuhov@invest.gazprom.ru							
vonipchenko@invest.gazprom.ru	pkasyanov@invest.gazprom.ru	apastuhov@invest.gazprom.ru	avernich@invest.gazprom.ru	oyualekseeva@invest.gazprom.ru	mbasalgin@invest.gazprom.ru	trepnikova@invest.gazprom.ru	ealferova@invest.gazprom.ru
ldautova@invest.gazprom.ru	mkiseleva@invest.gazprom.ru						
nfliginskikh@invest.gazprom.ru	yuspolyakova@invest.gazprom.ru	pfotiev@invest.gazprom.ru	rgusev@invest.gazprom.ru				
nfliginskikh@invest.gazprom.ru	yuspolyakova@invest.gazprom.ru						
asiver@invest.gazprom.ru	iprudova@invest.gazprom.ru						
ilezhoev@invest.gazprom.ru	ioslin@invest.gazprom.ru						
varistova@invest.gazprom.ru	mzhavoronkova@invest.gazprom.ru						
mmanelov@invest.gazprom.ru	sdanilov@invest.gazprom.ru						
aformikhin@invest.gazprom.ru	ekazantseva@invest.gazprom.ru						
strenin@invest.gazprom.ru							
eprotsenko@invest.gazprom.ru	isuvorov@invest.gazprom.ru						
mpeterson@invest.gazprom.ru	asagalaeva@invest.gazprom.ru						
iipetrov@invest.gazprom.ru	mbasov@invest.gazprom.ru						
mgalikhanov@invest.gazprom.ru	ekamuchev@invest.gazprom.ru						
elenchenko@invest.gazprom.ru	yukaramyshev@invest.gazprom.ru						
yuvyborov@invest.gazprom.ru	iustinov@invest.gazprom.ru						
ilyamina@invest.gazprom.ru							
mkhetagurova@invest.gazprom.ru	ichakin@invest.gazprom.ru						
eradina@invest.gazprom.ru	mveselova@invest.gazprom.ru						
mmeretukov@invest.gazprom.ru							
vepavlov@invest.gazprom.ru	anedospasov@invest.gazprom.ru						
yukornienkova@invest.gazprom.ru	vdyubanov@invest.gazprom.ru						
agetman@invest.gazprom.ru	malyohin@invest.gazprom.ru	schepik@invest.gazprom.ru					
ssukharevskiy@invest.gazprom.ru	opushkarev@invest.gazprom.ru						
nantonenko@invest.gazprom.ru	ezinoveva@invest.gazprom.ru						
adudin@invest.gazprom.ru	yagolko@invest.gazprom.ru						
usapogina@invest.gazprom.ru	asiver@invest.gazprom.ru						
vepavlov@invest.gazprom.ru	anedospasov@invest.gazprom.ru						
eradaeva@invest.gazprom.ru	ovoronkovich@invest.gazprom.ru						
povdina@invest.gazprom.ru	sbakuta@invest.gazprom.ru						
dmirsayanov@invest.gazprom.ru	tkorol@invest.gazprom.ru						
vkhamitova@invest.gazprom.ru	agrigoreva@invest.gazprom.ru						
mlipnitskaya@invest.gazprom.ru	mburundukova@invest.gazprom.ru						
irudenko@invest.gazprom.ru	kshamratov@invest.gazprom.ru						
yupoleschuk@invest.gazprom.ru	slitvin@invest.gazprom.ru						
vrusseva@invest.gazprom.ru	aalekseeva@invest.gazprom.ru						
abaranov@invest.gazprom.ru	nshvets@invest.gazprom.ru						
atartygin@invest.gazprom.ru	mmozgushin@invest.gazprom.ru						
efedorova@invest.gazprom.ru	gkotlov@invest.gazprom.ru						
apavlova@invest.gazprom.ru	aoleynikov@invest.gazprom.ru						
elunev@invest.gazprom.ru	akovalev@invest.gazprom.ru						
vsimonov@invest.gazprom.ru	npestunov@invest.gazprom.ru						
averin@invest.gazprom.ru	malekseeva@invest.gazprom.ru	aloginov@invest.gazprom.ru					
vsimonov@invest.gazprom.ru	npestunov@invest.gazprom.ru	asulima@invest.gazprom.ru					
